                                                            
                                                            
  ###############################################           
     #       #          #####           #                   
     #       #          #####           #                   
     #       #            ###########   #                   
     #       ############               #                 
     #       #                          #                   
     #########        #######           #                   
        #             #     #           #                   
        #     ###########   #           #                   
        #    ######    #    #           #                   
        ###########    #    #           #                   
        #              #    #           ######$             
        #          #####    #           #    #              
        #          #        #           #    #              
        #          #        ##################              
        ############                                        
                                                            
                                                            